Александар Јовић - ajovic@matf.bg.ac.rs 
Александра Костић - alex@matf.bg.ac.rs 
Александра Симић - asimic@matf.bg.ac.rs 
Ана Спасић - aspasic@matf.bg.ac.rs 
Анђелка Зечевић - andjelkaz@matf.bg.ac.rs 
Андријана Декић - andrijana@matf.bg.ac.rs 
Биљана Стојановић  - biljana@matf.bg.ac.rs 
Бобан Карапетровић - bkarapetrovic @matf.bg.ac.rs 
Бојана Ласковић - bojanal@matf.bg.ac.rs 
Данијела Симић - danijela@matf.bg.ac.rs 
др Биљана Вујошевић - bvujosevic@matf.bg.ac.rs 
др Ленка Главаш - lenka@matf.bg.ac.rs 
др Сана Стојановић  Ђурђевић - sana@matf.bg.ac.rs 
др Сташа Вујичић Станковић - stasa@matf.bg.ac.rs 
Филип Самарџић - samardza@matf.bg.ac.rs 
Илија Врећица - ilijav@matf.bg.ac.rs 
Иван Чукић - ivan@matf.bg.ac.rs 
Ивана Танасијевић - ivana@matf.bg.ac.rs 
Јелена Шкорић - skoric@matf.bg.ac.rs 
Јована Николић - jovanadj@matf.bg.ac.rs 
Маша Ђорић - masha@matf.bg.ac.rs 
Марија Цупарић - marijar@matf.bg.ac.rs 
Марија Ивановић - marijai@matf.bg.ac.rs 
Марија Јелић - marijaj@matf.bg.ac.rs 
Марија Микић - marijam@matf.bg.ac.rs 
Маријана Бабић - marijana@matf.bg.ac.rs 
Милан Банковић - milan@matf.bg.ac.rs 
Милан Лазаревић - lazarevic@matf.bg.ac.rs 
Милош Антић - antic@matf.bg.ac.rs 
Милош Ђорић - milosdj@matf.bg.ac.rs 
Мирјана Маљковић - mirjana@matf.bg.ac.rs 
Мирко Спасић - mirko@matf.bg.ac.rs 
мр Јелена Хаџи Пурић  - jelenagr@matf.bg.ac.rs 
мр Златко Лазовић  - zlatkol@matf.bg.ac.rs 
Никола Лелас - dzoni@matf.bg.ac.rs 
Никола Мутавџић - nikolam@matf.bg.ac.rs 
Нина Радојичић - nina@matf.bg.ac.rs 
Огњен Коцић - ognjen@matf.bg.ac.rs 
Петар Мелентијевић - petarmel@matf.bg.ac.rs 
Петар Стојчић - petars@matf.bg.ac.rs 
Соња Телебаковић  - sonjat@matf.bg.ac.rs 
Стефан Мишковић - stefan@matf.bg.ac.rs 
Виктор Радовић - rviktor@matf.bg.ac.rs 
