др Александар Картељ - kartelj@matf.bg.ac.rs 
др Александар Л. Савић - asavic@matf.bg.ac.rs 
др Александар Вучић  - avucic@matf.bg.ac.rs 
др Александра Делић - adelic@matf.bg.ac.rs 
др Ђорђе Кртинић  - georg@matf.bg.ac.rs 
др Бојан Новаковић - bojan@matf.bg.ac.rs 
др Бојана Милошевић - bojana@matf.bg.ac.rs 
др Бранислав Првуловић - bane@matf.bg.ac.rs 
др Драгана Илић  - dilic@matf.bg.ac.rs 
др Драгана Тодорић  - draganat@matf.bg.ac.rs 
др Душан Марчета - dmarceta@matf.bg.ac.rs 
др Душан Онић - donic@matf.bg.ac.rs 
др Горан Ђанковић - djankovic@matf.bg.ac.rs 
др Јелена Граовац  - jgraovac@matf.bg.ac.rs 
др Јелена Катић  - jelenak@matf.bg.ac.rs 
др Јована Ковачевић - jovana@matf.bg.ac.rs 
др Марко Обрадовић  - marcone@matf.bg.ac.rs 
др Марко Радовановић - markor@matf.bg.ac.rs 
др Милан Јовановић  - mjovanovic@matf.bg.ac.rs 
др Милена Вујошевић Јаничић - milena@matf.bg.ac.rs 
др Миљан В. Кнежевић  - kmiljan@matf.bg.ac.rs 
др Мирослава Антић   - mira@matf.bg.ac.rs 
др Младен Николић  - nikolic@matf.bg.ac.rs 
др Сандра Живановић - sandra@matf.bg.ac.rs 
др Славко Моцоња - slavko@matf.bg.ac.rs 
др Тања Стојадиновић - tanjas@matf.bg.ac.rs 
др Тијана Шукиловић  - tijana@matf.bg.ac.rs 
др Весна Маринковић  - vesnap@matf.bg.ac.rs 
др Владица Андрејић   - andrew@matf.bg.ac.rs 
др Зорица Дражић - zdrazic@matf.bg.ac.rs 
